111111111111
100000000001111111111
100000000000000000001
100000000001111111101
1000000000011111  101
100000000000000111101
111111111100000000001
        1000000111111
        11111111