111111111111
100000000001111111111
100020020000000000001
100000000001111111101
1000200200011111  101
100000000000000111101
111133111100000000001
  10000001000000111111
  100000011111111
  11111111